////////////////////////
///****************/////
/****************///////
/////************///////
/////////////*******ABE/
////////////////////////