////////////////////////
///************A***/////
/***********B****///////
/////************///////
/////////////*********E/
////////////////////////