/////////////
///*********/
/***********/
////******A//
/********////
////****/////
//****B***///
//***////////
/*******/////
/**********//
//******/////
///********//
//******E**//
/////////////